#####################
#S####   ##########E#  
#                   #
#                   #
#                   #
#                   #
#####################
